⬛🟧⬛⬛⬛⬛⬛⬛⬛⬛⬛⬛⬛⬛⬛⬛⬛⬛⬛⬛⬛⬛⬛⬛⬛⬛⬛⬛⬛⬛⬛⬛⬛⬛⬛⬛⬛⬛⬛⬛⬛⬛⬛⬛⬛⬛⬛⬛⬛⬛⬛⬛⬛⬛⬛⬛⬛⬛⬛⬛⬛
⬛⬜⬜⬜⬜⬜⬜⬜⬜⬜⬜⬜⬜⬜⬛⬜⬛⬜⬛⬜⬛⬜⬛⬜⬛⬜⬜⬜⬜⬜⬜⬜⬜⬜⬛⬜⬜⬜⬜⬜⬛⬜⬛⬜⬜⬜⬜⬜⬜⬜⬛⬜⬛⬜⬜⬜⬜⬜⬜⬜⬛
⬛⬜⬛⬛⬛⬜⬛⬜⬛⬛⬛⬜⬛⬛⬛⬜⬛⬜⬛⬜⬛⬜⬛⬜⬛⬜⬛⬛⬛⬛⬛⬛⬛⬛⬛⬜⬛⬛⬛⬛⬛⬜⬛⬛⬛⬜⬛⬛⬛⬜⬛⬜⬛⬜⬛⬛⬛⬛⬛⬛⬛
⬛⬜⬜⬜⬛⬜⬛⬜⬜⬜⬛⬜⬜⬜⬜⬜⬜⬜⬜⬜⬜⬜⬜⬜⬜⬜⬛⬜⬛⬜⬜⬜⬜⬜⬛⬜⬛⬜⬜⬜⬛⬜⬜⬜⬜⬜⬜⬜⬛⬜⬜⬜⬜⬜⬜⬜⬜⬜⬜⬜⬛
⬛⬛⬛⬛⬛⬜⬛⬜⬛⬜⬛⬜⬛⬛⬛⬜⬛⬜⬛⬛⬛⬜⬛⬛⬛⬛⬛⬜⬛⬛⬛⬛⬛⬜⬛⬜⬛⬜⬛⬛⬛⬜⬛⬛⬛⬜⬛⬜⬛⬜⬛⬜⬛⬛⬛⬜⬛⬛⬛⬛⬛
⬛⬜⬜⬜⬜⬜⬛⬜⬛⬜⬛⬜⬜⬜⬛⬜⬛⬜⬜⬜⬛⬜⬜⬜⬜⬜⬜⬜⬜⬜⬛⬜⬜⬜⬜⬜⬜⬜⬛⬜⬛⬜⬛⬜⬜⬜⬛⬜⬛⬜⬛⬜⬜⬜⬛⬜⬜⬜⬜⬜⬛
⬛⬛⬛⬜⬛⬜⬛⬜⬛⬜⬛⬜⬛⬛⬛⬛⬛⬛⬛⬜⬛⬜⬛⬛⬛⬛⬛⬛⬛⬛⬛⬛⬛⬜⬛⬛⬛⬛⬛⬜⬛⬜⬛⬛⬛⬜⬛⬜⬛⬛⬛⬛⬛⬛⬛⬜⬛⬛⬛⬛⬛
⬛⬜⬜⬜⬛⬜⬛⬜⬛⬜⬛⬜⬜⬜⬜⬜⬜⬜⬛⬜⬛⬜⬜⬜⬛⬜⬛⬜⬜⬜⬛⬜⬛⬜⬜⬜⬜⬜⬜⬜⬜⬜⬜⬜⬛⬜⬛⬜⬜⬜⬛⬜⬜⬜⬛⬜⬜⬜⬜⬜⬛
⬛⬛⬛⬜⬛⬛⬛⬜⬛⬛⬛⬜⬛⬜⬛⬛⬛⬛⬛⬛⬛⬛⬛⬛⬛⬜⬛⬜⬛⬛⬛⬜⬛⬜⬛⬛⬛⬛⬛⬜⬛⬛⬛⬛⬛⬛⬛⬛⬛⬛⬛⬜⬛⬛⬛⬜⬛⬜⬛⬛⬛
⬛⬜⬜⬜⬜⬜⬛⬜⬜⬜⬛⬜⬛⬜⬜⬜⬜⬜⬜⬜⬜⬜⬜⬜⬜⬜⬜⬜⬜⬜⬜⬜⬜⬜⬜⬜⬜⬜⬛⬜⬜⬜⬛⬜⬜⬜⬜⬜⬜⬜⬜⬜⬜⬜⬛⬜⬛⬜⬜⬜⬛
⬛⬜⬛⬛⬛⬛⬛⬜⬛⬛⬛⬜⬛⬜⬛⬜⬛⬛⬛⬜⬛⬜⬛⬜⬛⬜⬛⬛⬛⬛⬛⬜⬛⬛⬛⬜⬛⬜⬛⬛⬛⬛⬛⬜⬛⬜⬛⬜⬛⬛⬛⬛⬛⬛⬛⬛⬛⬛⬛⬛⬛
⬛⬜⬜⬜⬛⬜⬛⬜⬛⬜⬜⬜⬛⬜⬛⬜⬜⬜⬛⬜⬛⬜⬛⬜⬛⬜⬜⬜⬛⬜⬜⬜⬛⬜⬜⬜⬛⬜⬜⬜⬜⬜⬛⬜⬛⬜⬛⬜⬜⬜⬛⬜⬜⬜⬜⬜⬜⬜⬛⬜⬛
⬛⬜⬛⬛⬛⬜⬛⬛⬛⬜⬛⬛⬛⬛⬛⬜⬛⬛⬛⬜⬛⬛⬛⬜⬛⬛⬛⬛⬛⬛⬛⬜⬛⬛⬛⬜⬛⬛⬛⬜⬛⬛⬛⬜⬛⬜⬛⬛⬛⬛⬛⬜⬛⬛⬛⬛⬛⬛⬛⬜⬛
⬛⬜⬜⬜⬜⬜⬛⬜⬛⬜⬛⬜⬛⬜⬛⬜⬜⬜⬛⬜⬜⬜⬛⬜⬜⬜⬜⬜⬛⬜⬛⬜⬜⬜⬛⬜⬛⬜⬛⬜⬛⬜⬛⬜⬛⬜⬜⬜⬛⬜⬛⬜⬜⬜⬜⬜⬛⬜⬛⬜⬛
⬛⬜⬛⬜⬛⬜⬛⬜⬛⬛⬛⬜⬛⬜⬛⬜⬛⬛⬛⬛⬛⬛⬛⬜⬛⬜⬛⬛⬛⬜⬛⬜⬛⬛⬛⬜⬛⬜⬛⬜⬛⬜⬛⬜⬛⬛⬛⬜⬛⬜⬛⬜⬛⬛⬛⬛⬛⬜⬛⬜⬛
⬛⬜⬛⬜⬛⬜⬜⬜⬛⬜⬜⬜⬜⬜⬜⬜⬜⬜⬜⬜⬛⬜⬜⬜⬛⬜⬜⬜⬜⬜⬛⬜⬛⬜⬜⬜⬜⬜⬛⬜⬜⬜⬜⬜⬜⬜⬛⬜⬜⬜⬜⬜⬜⬜⬛⬜⬜⬜⬜⬜⬛
⬛⬛⬛⬜⬛⬛⬛⬜⬛⬜⬛⬛⬛⬛⬛⬜⬛⬛⬛⬛⬛⬛⬛⬛⬛⬛⬛⬜⬛⬛⬛⬜⬛⬜⬛⬜⬛⬜⬛⬜⬛⬜⬛⬜⬛⬜⬛⬛⬛⬜⬛⬜⬛⬜⬛⬜⬛⬜⬛⬛⬛
⬛⬜⬜⬜⬜⬜⬛⬜⬛⬜⬛⬜⬜⬜⬜⬜⬜⬜⬜⬜⬜⬜⬛⬜⬜⬜⬛⬜⬜⬜⬛⬜⬛⬜⬛⬜⬛⬜⬛⬜⬛⬜⬛⬜⬛⬜⬜⬜⬛⬜⬛⬜⬛⬜⬜⬜⬛⬜⬛⬜⬛
⬛⬛⬛⬜⬛⬜⬛⬛⬛⬜⬛⬜⬛⬜⬛⬛⬛⬜⬛⬛⬛⬛⬛⬜⬛⬜⬛⬜⬛⬛⬛⬜⬛⬛⬛⬜⬛⬛⬛⬛⬛⬛⬛⬜⬛⬛⬛⬛⬛⬛⬛⬛⬛⬛⬛⬛⬛⬛⬛⬜⬛
⬛⬜⬜⬜⬛⬜⬛⬜⬜⬜⬛⬜⬛⬜⬜⬜⬛⬜⬜⬜⬛⬜⬜⬜⬛⬜⬛⬜⬜⬜⬛⬜⬛⬜⬜⬜⬜⬜⬛⬜⬜⬜⬛⬜⬜⬜⬜⬜⬜⬜⬜⬜⬜⬜⬜⬜⬜⬜⬜⬜⬛
⬛⬜⬛⬜⬛⬛⬛⬜⬛⬛⬛⬛⬛⬜⬛⬛⬛⬛⬛⬛⬛⬜⬛⬛⬛⬛⬛⬜⬛⬛⬛⬜⬛⬛⬛⬛⬛⬜⬛⬜⬛⬜⬛⬛⬛⬛⬛⬜⬛⬛⬛⬛⬛⬜⬛⬜⬛⬛⬛⬜⬛
⬛⬜⬛⬜⬜⬜⬛⬜⬛⬜⬜⬜⬜⬜⬜⬜⬛⬜⬜⬜⬜⬜⬛⬜⬛⬜⬛⬜⬛⬜⬛⬜⬜⬜⬛⬜⬜⬜⬜⬜⬛⬜⬜⬜⬛⬜⬛⬜⬜⬜⬜⬜⬛⬜⬛⬜⬜⬜⬛⬜⬛
⬛⬛⬛⬜⬛⬛⬛⬛⬛⬛⬛⬜⬛⬛⬛⬜⬛⬜⬛⬜⬛⬜⬛⬜⬛⬜⬛⬛⬛⬜⬛⬜⬛⬜⬛⬛⬛⬜⬛⬛⬛⬛⬛⬜⬛⬜⬛⬜⬛⬜⬛⬜⬛⬛⬛⬜⬛⬛⬛⬜⬛
⬛⬜⬜⬜⬜⬜⬛⬜⬜⬜⬜⬜⬛⬜⬜⬜⬛⬜⬛⬜⬛⬜⬜⬜⬛⬜⬛⬜⬜⬜⬛⬜⬛⬜⬛⬜⬜⬜⬜⬜⬜⬜⬛⬜⬜⬜⬛⬜⬛⬜⬛⬜⬛⬜⬜⬜⬜⬜⬛⬜⬛
⬛⬜⬛⬛⬛⬛⬛⬜⬛⬛⬛⬜⬛⬛⬛⬜⬛⬜⬛⬛⬛⬛⬛⬛⬛⬜⬛⬜⬛⬛⬛⬛⬛⬛⬛⬜⬛⬜⬛⬜⬛⬜⬛⬛⬛⬜⬛⬜⬛⬜⬛⬛⬛⬛⬛⬛⬛⬜⬛⬛⬛
⬛⬜⬛⬜⬜⬜⬜⬜⬛⬜⬜⬜⬜⬜⬛⬜⬜⬜⬜⬜⬜⬜⬜⬜⬜⬜⬛⬜⬜⬜⬛⬜⬛⬜⬛⬜⬛⬜⬛⬜⬛⬜⬜⬜⬛⬜⬛⬜⬛⬜⬜⬜⬜⬜⬜⬜⬛⬜⬜⬜⬛
⬛⬜⬛⬛⬛⬛⬛⬛⬛⬛⬛⬜⬛⬛⬛⬜⬛⬜⬛⬛⬛⬜⬛⬜⬛⬛⬛⬛⬛⬜⬛⬜⬛⬜⬛⬛⬛⬜⬛⬜⬛⬜⬛⬜⬛⬜⬛⬛⬛⬛⬛⬜⬛⬜⬛⬜⬛⬛⬛⬛⬛
⬛⬜⬛⬜⬜⬜⬜⬜⬜⬜⬛⬜⬛⬜⬜⬜⬛⬜⬛⬜⬜⬜⬛⬜⬜⬜⬛⬜⬜⬜⬜⬜⬜⬜⬛⬜⬛⬜⬛⬜⬛⬜⬛⬜⬛⬜⬜⬜⬛⬜⬛⬜⬛⬜⬛⬜⬜⬜⬜⬜⬛
⬛⬛⬛⬜⬛⬛⬛⬛⬛⬜⬛⬛⬛⬛⬛⬜⬛⬛⬛⬜⬛⬜⬛⬛⬛⬛⬛⬜⬛⬜⬛⬜⬛⬜⬛⬜⬛⬛⬛⬛⬛⬛⬛⬛⬛⬛⬛⬛⬛⬜⬛⬛⬛⬜⬛⬛⬛⬛⬛⬛⬛
⬛⬜⬜⬜⬛⬜⬜⬜⬜⬜⬜⬜⬜⬜⬜⬜⬛⬜⬜⬜⬛⬜⬛⬜⬛⬜⬜⬜⬛⬜⬛⬜⬛⬜⬜⬜⬛⬜⬛⬜⬛⬜⬛⬜⬜⬜⬜⬜⬜⬜⬜⬜⬛⬜⬛⬜⬜⬜⬛⬜⬛
⬛⬜⬛⬜⬛⬛⬛⬛⬛⬜⬛⬛⬛⬜⬛⬛⬛⬛⬛⬛⬛⬜⬛⬜⬛⬜⬛⬛⬛⬜⬛⬛⬛⬛⬛⬛⬛⬜⬛⬜⬛⬜⬛⬜⬛⬛⬛⬜⬛⬛⬛⬛⬛⬛⬛⬜⬛⬛⬛⬜⬛
⬛⬜⬛⬜⬜⬜⬛⬜⬜⬜⬛⬜⬜⬜⬜⬜⬜⬜⬜⬜⬛⬜⬜⬜⬜⬜⬜⬜⬛⬜⬛⬜⬜⬜⬛⬜⬛⬜⬜⬜⬜⬜⬛⬜⬜⬜⬛⬜⬜⬜⬜⬜⬛⬜⬛⬜⬜⬜⬜⬜⬛
⬛⬜⬛⬜⬛⬛⬛⬛⬛⬜⬛⬛⬛⬜⬛⬜⬛⬛⬛⬛⬛⬜⬛⬜⬛⬛⬛⬛⬛⬛⬛⬜⬛⬛⬛⬜⬛⬜⬛⬛⬛⬛⬛⬜⬛⬜⬛⬛⬛⬛⬛⬛⬛⬜⬛⬜⬛⬜⬛⬛⬛
⬛⬜⬛⬜⬛⬜⬜⬜⬜⬜⬜⬜⬛⬜⬛⬜⬜⬜⬜⬜⬛⬜⬛⬜⬜⬜⬜⬜⬛⬜⬜⬜⬜⬜⬜⬜⬜⬜⬜⬜⬛⬜⬛⬜⬛⬜⬛⬜⬜⬜⬜⬜⬛⬜⬜⬜⬛⬜⬜⬜⬛
⬛⬜⬛⬜⬛⬛⬛⬜⬛⬛⬛⬜⬛⬛⬛⬜⬛⬜⬛⬛⬛⬜⬛⬜⬛⬜⬛⬜⬛⬜⬛⬛⬛⬜⬛⬛⬛⬛⬛⬛⬛⬜⬛⬛⬛⬜⬛⬜⬛⬛⬛⬜⬛⬛⬛⬛⬛⬜⬛⬛⬛
⬛⬜⬛⬜⬛⬜⬜⬜⬜⬜⬛⬜⬛⬜⬜⬜⬛⬜⬛⬜⬛⬜⬛⬜⬛⬜⬛⬜⬛⬜⬛⬜⬛⬜⬜⬜⬛⬜⬜⬜⬛⬜⬛⬜⬜⬜⬛⬜⬜⬜⬛⬜⬜⬜⬛⬜⬛⬜⬜⬜⬛
⬛⬜⬛⬜⬛⬛⬛⬛⬛⬜⬛⬛⬛⬛⬛⬜⬛⬛⬛⬜⬛⬜⬛⬛⬛⬜⬛⬛⬛⬜⬛⬜⬛⬜⬛⬛⬛⬜⬛⬛⬛⬜⬛⬜⬛⬜⬛⬜⬛⬛⬛⬛⬛⬛⬛⬜⬛⬜⬛⬛⬛
⬛⬜⬛⬜⬛⬜⬜⬜⬜⬜⬛⬜⬜⬜⬜⬜⬜⬜⬜⬜⬛⬜⬜⬜⬛⬜⬜⬜⬜⬜⬛⬜⬛⬜⬛⬜⬛⬜⬜⬜⬜⬜⬜⬜⬛⬜⬜⬜⬜⬜⬜⬜⬛⬜⬜⬜⬛⬜⬛⬜⬛
⬛⬜⬛⬜⬛⬛⬛⬛⬛⬜⬛⬛⬛⬛⬛⬜⬛⬜⬛⬛⬛⬛⬛⬜⬛⬜⬛⬜⬛⬜⬛⬜⬛⬛⬛⬜⬛⬛⬛⬜⬛⬛⬛⬛⬛⬛⬛⬜⬛⬜⬛⬛⬛⬜⬛⬜⬛⬜⬛⬜⬛
⬛⬜⬛⬜⬛⬜⬜⬜⬜⬜⬛⬜⬜⬜⬜⬜⬛⬜⬜⬜⬜⬜⬛⬜⬛⬜⬛⬜⬛⬜⬜⬜⬛⬜⬜⬜⬜⬜⬜⬜⬜⬜⬜⬜⬜⬜⬛⬜⬛⬜⬜⬜⬛⬜⬛⬜⬛⬜⬜⬜⬛
⬛⬜⬛⬛⬛⬜⬛⬛⬛⬜⬛⬛⬛⬜⬛⬜⬛⬛⬛⬜⬛⬛⬛⬜⬛⬛⬛⬜⬛⬜⬛⬛⬛⬛⬛⬜⬛⬛⬛⬜⬛⬜⬛⬛⬛⬛⬛⬛⬛⬛⬛⬛⬛⬜⬛⬛⬛⬜⬛⬛⬛
⬛⬜⬛⬜⬛⬜⬛⬜⬜⬜⬛⬜⬜⬜⬛⬜⬛⬜⬜⬜⬜⬜⬛⬜⬛⬜⬜⬜⬛⬜⬜⬜⬜⬜⬜⬜⬜⬜⬛⬜⬛⬜⬜⬜⬜⬜⬛⬜⬜⬜⬛⬜⬜⬜⬛⬜⬜⬜⬜⬜⬛
⬛⬜⬛⬜⬛⬛⬛⬜⬛⬜⬛⬜⬛⬜⬛⬜⬛⬜⬛⬜⬛⬜⬛⬛⬛⬜⬛⬛⬛⬜⬛⬛⬛⬜⬛⬛⬛⬜⬛⬛⬛⬜⬛⬜⬛⬛⬛⬜⬛⬛⬛⬜⬛⬛⬛⬜⬛⬛⬛⬛⬛
⬛⬜⬛⬜⬜⬜⬜⬜⬛⬜⬛⬜⬛⬜⬛⬜⬛⬜⬛⬜⬛⬜⬛⬜⬜⬜⬛⬜⬜⬜⬛⬜⬜⬜⬜⬜⬛⬜⬛⬜⬜⬜⬛⬜⬛⬜⬜⬜⬛⬜⬜⬜⬛⬜⬜⬜⬜⬜⬜⬜⬛
⬛⬛⬛⬛⬛⬜⬛⬜⬛⬜⬛⬛⬛⬛⬛⬛⬛⬜⬛⬛⬛⬜⬛⬛⬛⬛⬛⬜⬛⬜⬛⬛⬛⬛⬛⬜⬛⬜⬛⬜⬛⬜⬛⬛⬛⬜⬛⬛⬛⬜⬛⬛⬛⬜⬛⬛⬛⬛⬛⬛⬛
⬛⬜⬜⬜⬜⬜⬛⬜⬛⬜⬛⬜⬜⬜⬛⬜⬜⬜⬜⬜⬛⬜⬜⬜⬜⬜⬛⬜⬛⬜⬜⬜⬜⬜⬛⬜⬛⬜⬛⬜⬛⬜⬜⬜⬜⬜⬜⬜⬜⬜⬜⬜⬛⬜⬜⬜⬜⬜⬜⬜⬛
⬛⬜⬛⬜⬛⬜⬛⬛⬛⬛⬛⬛⬛⬜⬛⬛⬛⬜⬛⬜⬛⬛⬛⬛⬛⬜⬛⬛⬛⬜⬛⬛⬛⬜⬛⬜⬛⬛⬛⬛⬛⬛⬛⬜⬛⬛⬛⬜⬛⬜⬛⬛⬛⬜⬛⬛⬛⬛⬛⬛⬛
⬛⬜⬛⬜⬛⬜⬜⬜⬛⬜⬜⬜⬜⬜⬜⬜⬜⬜⬛⬜⬛⬜⬜⬜⬜⬜⬛⬜⬜⬜⬛⬜⬜⬜⬛⬜⬜⬜⬜⬜⬜⬜⬛⬜⬜⬜⬛⬜⬛⬜⬜⬜⬜⬜⬛⬜⬛⬜⬛⬜⬛
⬛⬜⬛⬛⬛⬜⬛⬜⬛⬛⬛⬛⬛⬛⬛⬜⬛⬛⬛⬜⬛⬜⬛⬜⬛⬛⬛⬛⬛⬜⬛⬛⬛⬛⬛⬛⬛⬜⬛⬛⬛⬛⬛⬜⬛⬛⬛⬜⬛⬜⬛⬜⬛⬜⬛⬜⬛⬜⬛⬜⬛
⬛⬜⬛⬜⬜⬜⬛⬜⬛⬜⬜⬜⬜⬜⬜⬜⬜⬜⬛⬜⬛⬜⬛⬜⬜⬜⬜⬜⬛⬜⬜⬜⬛⬜⬜⬜⬜⬜⬜⬜⬜⬜⬛⬜⬜⬜⬛⬜⬛⬜⬛⬜⬛⬜⬜⬜⬜⬜⬜⬜⬛
⬛⬜⬛⬜⬛⬛⬛⬛⬛⬛⬛⬛⬛⬜⬛⬛⬛⬜⬛⬛⬛⬜⬛⬜⬛⬛⬛⬜⬛⬛⬛⬜⬛⬛⬛⬛⬛⬜⬛⬜⬛⬛⬛⬛⬛⬜⬛⬜⬛⬜⬛⬛⬛⬛⬛⬜⬛⬜⬛⬜⬛
⬛⬜⬛⬜⬛⬜⬜⬜⬜⬜⬜⬜⬜⬜⬛⬜⬜⬜⬜⬜⬛⬜⬛⬜⬛⬜⬛⬜⬜⬜⬛⬜⬛⬜⬜⬜⬜⬜⬛⬜⬛⬜⬜⬜⬜⬜⬛⬜⬛⬜⬜⬜⬜⬜⬛⬜⬛⬜⬛⬜⬛
⬛⬛⬛⬜⬛⬛⬛⬛⬛⬜⬛⬛⬛⬜⬛⬛⬛⬜⬛⬛⬛⬛⬛⬜⬛⬜⬛⬛⬛⬛⬛⬜⬛⬛⬛⬜⬛⬛⬛⬜⬛⬛⬛⬛⬛⬜⬛⬜⬛⬛⬛⬜⬛⬛⬛⬛⬛⬜⬛⬜⬛
⬛⬜⬜⬜⬛⬜⬜⬜⬜⬜⬜⬜⬛⬜⬛⬜⬜⬜⬜⬜⬛⬜⬜⬜⬜⬜⬛⬜⬛⬜⬜⬜⬜⬜⬛⬜⬛⬜⬜⬜⬜⬜⬛⬜⬜⬜⬛⬜⬜⬜⬛⬜⬜⬜⬜⬜⬛⬜⬛⬜⬛
⬛⬛⬛⬜⬛⬛⬛⬜⬛⬛⬛⬜⬛⬛⬛⬛⬛⬜⬛⬜⬛⬛⬛⬜⬛⬜⬛⬜⬛⬜⬛⬛⬛⬛⬛⬛⬛⬛⬛⬜⬛⬛⬛⬜⬛⬛⬛⬛⬛⬜⬛⬛⬛⬛⬛⬛⬛⬜⬛⬛⬛
⬛⬜⬜⬜⬛⬜⬜⬜⬜⬜⬛⬜⬛⬜⬜⬜⬜⬜⬛⬜⬛⬜⬜⬜⬛⬜⬛⬜⬜⬜⬜⬜⬜⬜⬛⬜⬛⬜⬜⬜⬜⬜⬛⬜⬜⬜⬛⬜⬜⬜⬜⬜⬜⬜⬜⬜⬛⬜⬜⬜⬛
⬛⬜⬛⬛⬛⬜⬛⬛⬛⬛⬛⬛⬛⬛⬛⬜⬛⬛⬛⬜⬛⬛⬛⬜⬛⬜⬛⬛⬛⬛⬛⬜⬛⬛⬛⬜⬛⬜⬛⬛⬛⬜⬛⬜⬛⬛⬛⬛⬛⬜⬛⬛⬛⬜⬛⬛⬛⬛⬛⬛⬛
⬛⬜⬛⬜⬜⬜⬜⬜⬜⬜⬛⬜⬛⬜⬜⬜⬜⬜⬛⬜⬛⬜⬜⬜⬛⬜⬜⬜⬛⬜⬜⬜⬛⬜⬜⬜⬜⬜⬜⬜⬛⬜⬛⬜⬜⬜⬜⬜⬛⬜⬛⬜⬜⬜⬜⬜⬜⬜⬜⬜⬛
⬛⬜⬛⬛⬛⬜⬛⬜⬛⬛⬛⬜⬛⬛⬛⬜⬛⬜⬛⬜⬛⬛⬛⬜⬛⬛⬛⬜⬛⬛⬛⬜⬛⬛⬛⬜⬛⬜⬛⬛⬛⬛⬛⬛⬛⬛⬛⬛⬛⬜⬛⬛⬛⬜⬛⬜⬛⬜⬛⬛⬛
⬛⬜⬜⬜⬛⬜⬛⬜⬛⬜⬜⬜⬜⬜⬜⬜⬛⬜⬛⬜⬜⬜⬛⬜⬛⬜⬜⬜⬛⬜⬜⬜⬛⬜⬜⬜⬛⬜⬜⬜⬜⬜⬜⬜⬜⬜⬜⬜⬛⬜⬛⬜⬜⬜⬛⬜⬛⬜⬜⬜⬛
⬛⬛⬛⬛⬛⬛⬛⬛⬛⬛⬛⬛⬛⬛⬛⬛⬛⬛⬛⬛⬛⬛⬛⬛⬛⬛⬛⬛⬛⬛⬛⬛⬛⬛⬛⬛⬛⬛⬛⬛⬛⬛⬛⬛⬛⬛⬛⬛⬛⬛⬛⬛⬛⬛⬛⬛⬛⬛⬛🟩⬛
